type octile
height 7
width 14
map
......T.......
..............
......T.......
......T.......
......T.......
..............
......T.......